1111111111111
10000001C1001
100000000C001
100P0C0010001
1111101101111
10000000E0001
1111111111111