1111111111
1000000001
100P00C0E1
1111111111